10 10

B B B B B B B B B B
- - B B - - - - - -
- - B B - - - - - -
- - B B - - - - - -
- - B B - - - - - -
- - B B - - - - - -
- - B B - - - - - -
- - B B - - - - - -
- - B - - - - - - -
- - B - - - - - - -
B - B - - - - - - B
B - B - - - - - - B
B - B - - - - - - B
B - B - - - - - - B
B - B - - - - - - B
B - B - - - - - - B
B - - - - - - - - B
B - - - - - - - - B
B - - - - - - - - B
B B B B B B B B B B
